111111111111111111111111111111111111111111111111111111111111
000010000000000000001000000000000010000000000000001000000000
000010000000000000001000000000000010000000000000001000000000
000000000000000000000000000000000010000000000000001000000000
000000000001000000000000000000000010000000000000001000000000
000000000001000000001000000000000010000000000000001000000000
000000000001000000001000000000000010000000000000001000000000
111111111111111111111111111111111111111111111111111111111111