111111111111111111111111111111111111111111111111111111111111
000010000000000000001000000000000010000000000000001000000000
000010000000000E00001000000000000010000000000000001000000000
000000000000000000000000000000000010000000000000001000000000
P00000000001000000000000000000000010000000000000001000000000
0000000000010000000010000000E0000010000000000000001000000000
00000E000001000000001000000000000010000000000000001000000000
111111111111111111111111111111111111111111111111111111111111