1111111111
1111111111
11P1111100
1010001000
1111111111
1000000000
11P1111100
1010001000
1111111111
1000000000
1111111111
1000000000